set wallbgcolor 0 0 50
set wallbrightcolor 0 0 255
set wallshadowcolor 0 0 255
set beancolor 102 54 47
ghost 0 color=CYAN chilling=1.0
ghost 1 color=PINK fast=1.0 seeker=10
ghost 2 color=ORANGE molten=10
ghost 3 color=RED fast=0.5

****************************
*            **            *
* **** ***** ** ***** **** *
*O**** ***** ** ***** ****O*
* **** ***** ** ***** **** *
*                          *
* **** ** ******** ** **** *
* **** ** ******** ** **** *
*      **    **    **      *
****** *****#**#***** ******
#####* *****#**#***** *#####
#####* **####3#####** *#####
#####* **#***##***#** *#####
****** **#***##***#** ******
###### ###**01#2**### ######
****** **#********#** ******
#####* **#********#** *#####
#####* **##########** *#####
#####* **#********#** *#####
****** **#********#** ******
*            **            *
* **** ***** ** ***** **** *
* **** ***** ** ***** **** *
*O  **       e        **  O*
*** ** ** ******** ** ** ***
*** ** ** ******** ** ** ***
*      **    **    **      *
* ********** ** ********** *
* ********** ** ********** *
*                          *
****************************
